#####################
#                   #
# P                 #
#                   #
#                   #
#         A         #
#                   #
#                   #
#                 S #
#                   #
#####################