#####################
#                   #
# P               R #
#                   #
#                   #
#         A         #
#                   #
#                   #
# R               P #
#                   #
#####################