#####################
#                   #
# P               S #
#                   #
#                   #
#         A         #
#                   #
#                   #
# S               P #
#                   #
#####################