#####################
#                   #
# P               O #
#                   #
#                   #
#         A         #
#                   #
#                   #
# O               P #
#                   #
#####################