%%%%%%%%%%%%%%%%%%%%%
%                   %
% P                 %
%                   %
%                   %
%         A         %
%                   %
%                   %
%                 P %
%                   %
%%%%%%%%%%%%%%%%%%%%%