%%%%%%%%%%%%%%%%%%%%%
%                   %
% P               S %
%                   %
%                   %
%         A         %
%                   %
%                   %
% P               P %
%                   %
%%%%%%%%%%%%%%%%%%%%%