%%%%%%%%%%%%%%%%%%%%%
%                   %
% P               O %
%                   %
%                   %
%         A         %
%                   %
%                   %
% P               P %
%                   %
%%%%%%%%%%%%%%%%%%%%%