#####################
#                   #
# P                 #
#                   #
#                   #
#         A         #
#                   #
#                   #
# P               P #
#                   #
#####################